R 1920 1080
NO ./ressources/tex_wall_N.xpm
SO ./ressources/tex_wall_S.xpm
WE ./ressources/tex_wall_W.xpm
EA ./ressources/tex_wall_E.xpm
S ./ressources/tex_wall_N.xpm
F 2,72,16
C 69,201,255
11111111111111111111111111111111111111111111
10000000000001000000000001000000000000000001
10000000000001000000000001000000000000000001
10000000000001000000000001000000000000000001
11100000000001000000000001000000000000000001
  100000000001000000000001000000000011111111
  10000000000000000000000000000000001
  11111111111111000000N00001111111111
               1111111111111
