R 1000 1000
NO ./ressources/tex_wall_N.xpm
SO ./ressources/tex_wall_S.xpm
WE ./ressources/tex_wall_W.xpm
EA ./ressources/tex_wall_E.xpm
S ./ressources/pikachu.xpm
F 0048,     0,     00024
C 200, 222, 255
11111111111111111111111111111111111111111111
10000000000001000000000001000000000000000001
10000000000001000000000001000000000000000001
10000000000001000000000001000000000000000001
11100000000001000000000001000000000000000001
  100000000001000002000001000000000011111111
  10000000000000000000000000000000001
  10000000000000000000000000000000001
  10000000000000000000000000000000001
  10000000000000000000000000000000001
  10000000000000000000000000000000001
  10000000000000000000000000000000001
  10000000000000000000000000000000001
  10000000000000000000000000000000001
  10000000000000000000000000000000001
  10000000000000000000000000000000001
  10000000000000000000000000000000001111111111111111111111111
  10000000000000000000000000000000000000000000000000000000001
  10000000000000000000000000000000000000000000000000000000001
  10000000000000000000000000000000000000000000000000000000001
  10000000000000000000000000000000001111111111111111111111101
  10000000000000000000000000000000001                     101
  10000000000000000000000000000000001                     101
  100000000000000000000S0000000000001                     101
  10000000000000000000000000000000001                     101
  10000000000000000000000000000000001                     101
  10000000000000000000000000000000001                     101
  10000000000000000000000000000000001                     101
  10000000000000000000000000000000001                     101
  10000000000000000000000000000000001                     101
  10000000000000000000000000000000001                     101
  10000000000000000000000000000000001                     101
  10000000000000000000000000000000001                     101
  10000000000000000000200000000000001                     101
  10000000000000000002220000000000001                     101
  10000000000000000000220000000000001                     101
  10000000000000000000002000000000001                 1111101111111
  10000000000000000000002200000000001                 1000000000001
  10000000000000000000000220000000001                 1000000000001
  10000000000000000000000000000000001                 1000000000001
  11111111111111000000000001111111111                 1000000000001
              1111111111111                           1000000000001
                        1111111111111111111111111111111000000000001
                        1000000000000000000000000000000000000000001
                        1111111111111111111111111111111111111111111
