R 1920 1080
NO ./ressources/tex_wall_N.xpm
SO ./ressources/tex_wall_S.xpm
WE ./ressources/tex_wall_W.xpm
EA ./ressources/tex_wall_E.xpm
S ./ressources/pikachu.xpm
F 255,72,16
C 200,222,255
11111111111111111111111111111111111111111111
10000000000001000000000001000000000000000001
10000000000001000000000001000000000000000001
10000000000001000000000001000000000000000001
11100000000001000000000001000000000000000001
  100000000001000002000001000000000011111111
  10000000000000000000000000000000001
  10000000000000000000000000000000001
  10000000000000000000000000000000001
  10000000000000000000000000000000001
  10000000000000000000000000000000001
  10000000000000000000000000000000001
  10000000000000000000000000000000001
  10000000000000000000000000000000001
  10000000000000000000000000000000001
  10000000000000000000000000000000001
  10000000000000000000000000000000001111111111111111111111111
  10000000000000000000000000000000000000000000000000000000001
  1000E000000000000000000000000000000000000000000000000000001
  10000000000000000000000000000000000000000000000000000000001
  10000000000000000000000000000000001111111111111111111111101
  10000000000000000000000000000000001                     101
  10000000000000000000000000000000001                     101
  10000000000000000000000000000000001                     101
  10000000000000000000000000000000001                     101
  10000000000000000000000000000000001                     101
  10000000000000000000000000000000001                     101
  10000000000000000000000000000000001                     101
  10000000000000000000000000000000001                     101
  10000000000000000000000000000000001                     101
  10000000000000000000000000000000001                     101
  10000000000000000000000000000000001                     101
  10000000000000000000000000000000001                     101
  10000000000000000000000000000000001                     101
  10000000000000000000000000000000001                     101
  10000000000000000000200000000000001                     101
  10000000000000000000000000000000001                 1111101111111
  10000000000000000000000000000000001                 1000000000001
  10000000000000000000000000000000001                 1000000000001
  10000000000000000000000000000000001                 1000000000001
  11111111111111000000000001111111111                 1000000000001
              1111111111111                           1000000000001
                        1111111111111111111111111111111000000000001
                        1000000000000000000000000000000000000000001
                        1111111111111111111111111111111111111111111
