R 21800 21000
NO ./ressources/tex_wall_N.xpm
SO ./ressources/tex_wall_S.xpm
WE ./ressources/tex_wall_W.xpm
EA ./ressources/tex_wall_E.xpm
S ./ressources/pikachu.xpm
F 255,72,16
C 200,-2255555555555555555555555555555555552,355
11111111111111111111111111
10000000000000000000000001
10000000000000000000000001
1000000000000000000000200111111
1111110000000001000000000000001
     10000000000000000000000001
     10000000000000000N00000001
1111110000000000000000000000001
1111111111111111111111111111111
