NO ./ressources/tex_wall_N.xpm
WE ./ressources/tex_wall_W.xpm
S ./ressources/pikachu.xpm
SO ./ressources/tex_wall_S.xpm
C 100,  	150,  		  24		
F 045, 		238,	187    			 
R    		420 		120
EA ./ressources/tex_wall_E.xpm
11111111111111111111111111
10000000000000000000000001
10000000000000000000000001
1000000000000000000000200111111
1111110000000001000000000000001
     10000000000000000000000001
     10000000000000000N00000001
1111110000000000000000000000001
1111111111111111111111111111111
