O ./ressources/tex_wall_N.xpm
WE ./ressources/tex_wall_W.xpm
SO ./ressources/tex_wall_S.xpm
C 45, 150, 		  24		
S ./ressources/pikachu.xpm
F 045, 		238,	187    			 
R    	2120, 	820
EA ./ressources/tex_wall_E.xpm
11111111111111111111111111
10000000000000000000000001
100000000000000000000000001
1000000000000000000000200111111
1111110000000001000000000000001
     10000000000000000000000001
    110E00000000000000000000001
1111110000000000000000000000001
1111111111111111111111111111111
